//MAP CONVERTED BY dmm2tgm.py THIS HEADER COMMENT PREVENTS RECONVERSION, DO NOT REMOVE
"a" = (
/turf/simulated/wall/auto/asteroid/typhon,
/area/typhon)
"F" = (
/turf/unsimulated/typhon,
/area/typhon)

(1,1,1) = {"
F
F
F
F
F
F
F
F
F
F
F
F
F
F
F
"}
(2,1,1) = {"
F
F
F
F
F
F
F
F
F
F
F
F
F
F
F
"}
(3,1,1) = {"
F
F
F
F
F
F
F
F
F
F
F
F
F
F
F
"}
(4,1,1) = {"
F
F
a
F
F
a
a
a
a
a
F
F
a
a
F
"}
(5,1,1) = {"
F
F
F
F
a
a
a
a
a
a
F
F
a
a
F
"}
(6,1,1) = {"
F
F
F
F
a
a
a
a
a
F
F
a
a
a
F
"}
(7,1,1) = {"
F
F
a
a
a
a
a
a
a
a
a
a
a
a
F
"}
(8,1,1) = {"
F
F
a
a
a
a
a
a
a
a
a
a
a
a
F
"}
(9,1,1) = {"
F
F
a
a
a
a
a
a
a
a
a
a
a
a
F
"}
(10,1,1) = {"
F
F
a
a
a
a
a
a
a
a
a
a
F
F
F
"}
(11,1,1) = {"
F
F
a
a
a
a
a
a
a
a
a
a
F
F
F
"}
(12,1,1) = {"
F
F
a
a
a
a
a
a
a
a
F
F
F
F
F
"}
(13,1,1) = {"
F
a
a
a
a
a
a
a
a
a
a
F
F
F
F
"}
(14,1,1) = {"
F
a
a
a
a
a
a
a
a
a
a
a
F
F
F
"}
(15,1,1) = {"
F
a
a
a
a
a
a
a
a
a
a
a
a
a
F
"}
