//MAP CONVERTED BY dmm2tgm.py THIS HEADER COMMENT PREVENTS RECONVERSION, DO NOT REMOVE
"a" = (
/turf/unsimulated/typhon,
/area/typhon)
"o" = (
/turf/simulated/wall/auto/asteroid/typhon,
/area/typhon)

(1,1,1) = {"
a
o
o
o
o
o
o
o
o
o
o
o
o
o
o
"}
(2,1,1) = {"
a
o
o
o
o
o
o
o
o
o
o
o
o
o
o
"}
(3,1,1) = {"
a
a
o
o
o
o
o
o
o
o
o
o
o
o
a
"}
(4,1,1) = {"
a
a
a
o
o
o
o
o
o
o
o
o
o
a
a
"}
(5,1,1) = {"
a
a
a
a
a
o
o
o
o
o
o
o
a
a
a
"}
(6,1,1) = {"
a
a
a
a
a
a
a
a
o
o
a
a
a
a
a
"}
(7,1,1) = {"
a
a
a
a
a
a
a
a
a
a
a
a
a
a
a
"}
(8,1,1) = {"
a
a
a
a
a
a
a
a
a
a
a
a
a
a
a
"}
(9,1,1) = {"
a
a
a
a
a
a
a
a
a
a
a
a
a
a
a
"}
(10,1,1) = {"
a
a
a
a
a
a
a
a
a
a
a
a
a
a
a
"}
(11,1,1) = {"
a
a
o
o
a
a
a
a
a
a
a
a
a
a
a
"}
(12,1,1) = {"
a
a
o
o
o
a
a
a
a
a
o
o
o
o
a
"}
(13,1,1) = {"
a
a
o
o
o
o
o
o
o
o
o
o
o
o
a
"}
(14,1,1) = {"
a
o
o
o
o
o
o
o
o
o
o
o
o
o
a
"}
(15,1,1) = {"
a
o
o
o
o
o
o
o
o
o
o
o
o
o
a
"}
